-1,1,1,1,1,1,1,1,1,1,1,1
-1,17,0,7,23,39,55,0,0,0,0,1
-1,17,33,49,45,0,0,0,62,0,60,100
-1,17,51,51,51,35,0,67,51,51,31,1
-1,1,5,5,5,5,0,5,5,5,5,1
-1,17,63,2,0,0,0,0,0,0,0,1
-1,17,51,51,51,15,0,47,51,51,51,1
-1,17,5,5,5,5,0,5,5,5,1,1
-1,1,71,0,0,0,0,0,0,0,71,1
-1,17,51,31,51,35,0,67,51,51,51,19
-1,17,5,5,5,5,0,5,5,5,5,19
-1,17,0,0,0,0,72,0,0,3,0,19
-1,1,51,51,51,35,0,67,51,51,51,19
-1,17,5,5,5,5,0,5,5,5,5,19
-1,17,59,71,0,0,0,0,0,71,0,19
-1,17,90,90,90,43,27,43,90,90,90,1
-1,1,1,1,1,1,1,1,1,1,1,1
