1,1,1,1,1,1,1,1,1,1,1
17,0,7,23,39,55,23,39,55,8,1
17,33,49,65,0,0,0,0,0,0,0
1,51,51,51,35,0,67,51,51,51,1
17,5,5,5,5,60,5,5,5,5,1
17,0,0,0,0,56,0,0,0,0,1
1,51,51,51,35,0,47,51,31,51,1
17,0,0,0,0,0,0,0,0,1,1
17,0,0,0,0,0,0,0,0,0,19
1,0,0,0,0,72,0,0,0,0,19
17,0,0,0,0,62,0,0,0,0,19
17,0,0,0,0,0,0,0,0,0,19
1,0,0,0,0,0,0,0,0,0,19
17,0,0,0,0,0,0,0,0,0,19
17,0,0,0,0,0,0,0,0,0,19
1,90,90,90,43,27,43,90,90,90,1
1,1,1,1,1,1,1,1,1,1,1
