1,1,1,1,1,1,1,1,1,1,1
17,0,7,23,39,55,23,39,55,8,1
17,33,29,65,0,0,0,3,72,60,100
17,61,0,0,0,0,0,0,0,0,1
1,0,0,0,0,0,0,0,0,0,1
17,71,6,44,67,15,0,14,4,0,1
17,71,6,48,5,0,0,50,4,0,1
17,71,6,48,0,0,0,30,4,0,1
1,71,6,28,58,47,35,50,4,0,1
17,71,6,48,0,5,59,50,4,0,19
17,71,6,12,0,58,0,66,4,0,19
17,0,0,47,51,51,31,15,0,0,19
1,3,0,5,5,5,5,5,0,0,19
17,0,0,0,0,0,0,0,2,0,19
17,0,0,62,0,59,0,62,0,0,19
17,90,90,90,43,27,43,90,90,90,1
1,1,1,1,1,1,1,1,1,1,1
