113,113,-1,-1,113,113,113,-1,-1,-1,-1,113,-1,-1,-1,-1
-1,-1,-1,-1,-1,113,113,-1,-1,113,-1,-1,113,-1,-1,-1
-1,-1,-1,-1,-1,-1,-1,-1,-1,113,-1,-1,-1,-1,-1,-1
1,1,19,19,19,1,19,19,19,1,19,19,19,1,1,1
1,89,62,0,0,0,0,0,58,0,0,0,62,14,61,1
1,89,0,6,64,34,4,2,0,44,14,4,0,50,4,1
1,40,62,6,48,50,4,0,0,48,30,4,0,66,20,1
1,40,59,6,12,46,4,0,63,32,66,4,0,0,36,1
1,24,7,0,71,71,62,0,5,71,71,0,0,58,52,1
1,24,0,0,71,71,0,0,0,71,71,0,0,0,20,1
1,40,3,6,44,14,4,0,6,64,34,4,0,2,36,1
1,40,0,6,48,30,4,58,6,28,50,4,0,0,52,1
1,89,0,59,28,50,4,0,6,48,50,4,72,0,0,1
1,89,58,6,48,50,4,0,59,48,50,4,60,0,9,1
1,1,1,1,1,1,1,1,1,1,1,1,99,1,1,1
